Level 6 (merci à E. Porte)
43
#########
## H ####
##BBB####
#    ####
##TP  ###
##M#BB  #
##  B M##
##### B #
##### D##
#########