Level 9 (merci à G. Héricourt)
15
#####D#####
##### B####
#####  ####
## ##B # ##
#   # B   #
#   KL#####
##H      ##
###########